char map[MAP_X][MAP_Y] ={

   { "1111111111111111111111111111111111111111111111111111111111111111111111111111111111111111111111111111"},
   { "1000000011000000000000000000000110000000000000000000000000000000000000000000000000000000000000000001" },
   { "1000000011000000000000000000000110000000000000000000000000000000000000000000000000000000000000000001" },
   { "1000000011000000000000000000000110000000000111111111111111111111111111000000111111111111111111111111" },
   { "1000000011111111111111110000011110000000000110000000000000000000000000000000110000000000000000000001" },
   { "1000000000000000000000000000000000000000000110000000000000000000000000000000110000000000000000000001" },
   { "1000000000000000000000000000000000000000000110000000000000000000000000000000110000000000000000000001" },
   { "1000000000000000000000000000000000000000000110000000000000000000000000000000110000000000000000000001" },
   { "1000000000000000000000000000000000000000000110000000000000000000000000000000110000000000000000000001" },
   { "1000000000000000000000000000000000000000000110000000000000000000000000000000110000000000000000000001" },
   { "1000000000000000000000000000000111111110000110000000000000000000000000000000111111111111111111100001" },
   { "1000000000000000000000000000000110000000000110000000000000000000000000000000000000000000000000000001" },
   { "1000000000000000000000000000000110000000000110000000000000000000000000000000000000000000000000000001" },
   { "1000000000000000000000000000000110000000000110000000000000000000000000000000000000000000000000000001" },
   { "1111111111111111111111111111111111111111111111111111100000000000000111111111111111111111111111111111" },
   { "1000000000000000000000000000000000000000000000000001100000000000000110000000000000000000000000000001" },
   { "1000000000000000000000000000000000000000000000000001100000000000000110000000000000000000000000000001" },
   { "1000000000000000000000000000000000000000000000000001100000000000000110000000000000000000000000000001" },
   { "1000000000000000000000000000000000000000000000000001100000000000000110000000000000000000000000000001" },
   { "1000000000000000000000000000000000000000000000000001100000000000000000000000000000000000000000000001" },
   { "1000000000000001111111111111111111100000110000000001100000000000000000000000000000000000000000000001" },
   { "1000000000000001100000000000000000000000110000000001100000000000000000000000000000000000000000000001" },
   { "1000000000000001100000000000000000000000110000000001111111111000001111111111111111111111111111111111" },
   { "1000000000000001100000000000000000000000110000000000000000000000000000000000000000000000000000000001" },
   { "1000000000000001100000000000000000000000110000000000000000000000000000000000000000000000000000000001" },
   { "1000000000000001100000000000000000000000110000000000000000000000000000000000000000000000000000000001" },
   { "1111111111111111111111111111111111111111111111111111111111111111111111111111111111111111111111111111" }

};
char map2[MAP_X][MAP_Y] ={

   { "1111111111111111111111111111111111111111111111111111111111111111111111111111111111111111111111111111"},
   { "1000000001100000000001111111111111111111110000000001100000000000000000000000000000000000000000000001" },
   { "1000000001100000000001111111111111111111110000000001100000000000000000000000000000000000000000000001" },
   { "1000000001100000000000000000000000000000000000000001111111111111111111111111111111111111111111100001" },
   { "1000000001100000000000000000000000000000000000000001100000000000001100000000000000000000000001100001" },
   { "1000000001100000000000000000000000000000110000000001100000000000001100000000000000000000000001100001" },
   { "1000000001111111111111111111111111111111110000000001100001111111111100000000000000000000000001100001" },
   { "1000000000000000000000000000000000000000000000000001100001100000000000000000000000000000000001100001" },
   { "1000000000000000000000000000000000000000000000000001100001111111111111111111111111111111000001100001" },
   { "1111111111111111111111111111111111111111110000000001100000000000000000000000000000000000000001100001" },
   { "1000000000000011111111111111111100000000000000000001100000000000000000000000000000000000000001100001" },
   { "1000000000000000000000000000000000000000000000000001111111111111111111111111111111111111000001100001" },
   { "1000000000000000000000000000000000000000000000000001100000000000000000000000011000000000000001100001" },
   { "1111111111111111111111111111111111111111110000000000000000000000000000000000011000000000000000000001" },
   { "1000000000000000000000000000000000000000110000000000000000000000000000000000011000000000000000000001" },
   { "1000000000000000000000000000000000000000111111111111111111111111000000000000011000000000000000000001" },
   { "1000000000000000000000000000000000000000000000000000000000000000000000000000011000000000000000000001" },
   { "1000000000000000000000000000000000000000000000000000000000000000000000000000011111111111111111100001" },
   { "1000000000111111111111111111111111111111000000000000000000000000000000000000011000000000000000000001" },
   { "1000000000110000000000000000000000000011111111111111111111111111000000000000011000000000000000000001" },
   { "1000000000110000000000000000000000000011000000000000000000000011000000000000011000000000000000000001" },
   { "1000000000110000000000000000000000000011000000000000000000000011000001111111111111110000000000000001" },
   { "1000000000110000000000001111111000000011000000000000000000000011000001100000000000110000000000000001" },
   { "1000000000110000000000001100000000000011111111111111111110000011000001100000000000110000000000000001" },
   { "10000000001100000000000011000000000000000000000000000000000000000000000000000000000000000000000001" },
   { "1000000000110000000000001100000000000000000000000000000000000000000000000000000000000000000000000001" },
   { "1111111111111111111111111111111111111111111111111111111111111111111111111111111111111111111111111111" }

};

char map3[MAP_X][MAP_Y] ={

   { "1111111111111111111111111111111111111111111111111111111111111111111111111111111111111111111111111111"},
   { "1000001100000000000000000000000000000000000000000000110000001100001100000000000000110000000000000001" },
   { "1000001100000000000000000000000000000000000000000000110000001100001100000000000000110000000000000001" },
   { "1000001100000011111111111111111111111111111111100000110000001100001100000000000000110000000000000001" },
   { "1000001100000011000000000000110000000000000001100000110000001100001100000000000000110000000000000001" },
   { "1000001100000011000000000000110000000000000001100000110000001100001101111111110000111111111111100001" },
   { "1000001100000011000000000000110000000000000001100000110000001100000000000000110000110000000001100001" },
   { "1000001111111111100000000000110000000000000001100000110000001100000000000000110000110000000001100001" },
   { "1000000000000000000000000000110000000000000001100000110000001111111110000000110000110000000001100001" },
   { "1000000000000000000000000000110000011111111111100000110000000000000000000000110000000000000001100001" },
   { "1111111111111111110000111111110000000000000000000000000000000000000000000000110000000000000001100001" },
   { "1000000000000000000000000000000000000000000000000000000011111111111111111111110000111111111111100001" },
   { "1000000000000000000000000000000000000000000000000000000000000000000000000000000000110000000000000001" },
   { "1000000011111111111111111111111111111111111111100000000000000000000000000000000000110000000000000001" },
   { "1000000011000011000000000000000000000011000000000000000000000000001100000000000000111111111111100001" },
   { "1000000011000011000000000000000000000011000000000000000000000000001100000000001111000000000000000001" },
   { "1111100011000011000011111111111110000011000000000000111111111111111100000000001100000000000000000001" },
   { "1000000011000011000011000000000000000011000000000000000000000000001100000000001111111111110000000001" },
   { "1000000011000011000011000000000000000011000000000000000000000000001100000000000000000000000000000001" },
   { "1000000011000000000011000000000000000000000000000000000000000000001100000000000000000000000000000001" },
   { "1000000011000000000011000000000000000000000000000000000000000000001100000000000000000000111111100001" },
   { "1111111111111111111111111111111111111111111111111111111111000000001111111111111100000000110000000001" },
   { "1000000000000110000000000001100000000000000000000000000000000000001100000000001100000000110000000001" },
   { "1000001111111110000000000001111111111111111111111111111111000000001100000000001111110000111111111111" },
   { "1000000000000000000000000000000000000000000000000000000000000000001100000000000000000000000000000001" },
   { "1000000000000000000000000000000000000000000000000000000000000000001100000000000000000000000000000001" },
   { "1111111111111111111111111111111111111111111111111111111111111111111111111111111111111111111111111111" }

};

